##############################
#    555                     #
#    555        #######      #
#    55544444999#            #
#    555444449#9             #
#    555444449994444         #
#    555222222222224         #
#    555244447774 14  4444444#
#S   12224664444  1444411111X#
#    5555466477999111111     #
#    5555   4888             #
#    5555    999             #
#    5555    9#9             #
#    5555    999#            #
#    5555       #            #
#    5555       #            #
##############################
